1111111111111
1E010000000C1
1000011111E01
1P0011E0000C1
1111111111111
